11111111111111
1100000000EC11
110P0C10001011
11111111111111
