111111111111
1C001C0000E1
1000000000C1
100000001011
1P1C111110C1
111111111111
