111111111111
1C001C0000E1
100000000011
100000001001
1P1C111110C1
111111111111
